0000000000000000
0111000000000000
0101111111101110
0101000010111010
0101000010010010
0101111010110010
0100000000100000
0101111111111110
0100000010010010
0111000010010010
00010000100110F0
001111I010000000
0010000010011110
0010000010010010
0011111111110010
0000000000000000